//MAP CONVERTED BY dmm2tgm.py THIS HEADER COMMENT PREVENTS RECONVERSION, DO NOT REMOVE
"a" = (
/obj/docking_port/mobile/arrow_elevator,
/turf/closed/shuttle/elevator{
	dir = 10
	},
/area/shuttle/arrowhead_new/elevator)
"b" = (
/turf/closed/shuttle/elevator/gears,
/area/shuttle/arrowhead_new/elevator)
"k" = (
/turf/closed/shuttle/elevator{
	dir = 4
	},
/area/shuttle/arrowhead_new/elevator)
"m" = (
/obj/structure/machinery/computer/shuttle/elevator_controller,
/turf/closed/shuttle/elevator{
	dir = 4
	},
/area/shuttle/arrowhead_new/elevator)
"q" = (
/obj/structure/prop/invuln/lifeboat_hatch_placeholder/terminal{
	desc = "Used to access below the elevator, locked shut currently.";
	layer = 2.1;
	name = "maintenence panel";
	pixel_x = 1
	},
/turf/open/shuttle/elevator,
/area/shuttle/arrowhead_new/elevator)
"u" = (
/turf/closed/shuttle/elevator{
	dir = 5
	},
/area/shuttle/arrowhead_new/elevator)
"z" = (
/turf/closed/shuttle/elevator{
	dir = 6
	},
/area/shuttle/arrowhead_new/elevator)
"A" = (
/obj/effect/decal/warning_stripes{
	icon_state = "W"
	},
/obj/effect/decal/warning_stripes{
	icon_state = "E";
	pixel_x = 1
	},
/obj/structure/machinery/light{
	dir = 8
	},
/turf/open/floor/engine,
/area/shuttle/arrowhead_new/elevator)
"C" = (
/obj/effect/decal/warning_stripes{
	icon_state = "W"
	},
/obj/effect/decal/warning_stripes{
	icon_state = "N";
	pixel_y = 1
	},
/obj/effect/decal/warning_stripes{
	icon_state = "SE-out";
	pixel_x = 1
	},
/obj/structure/bed/chair/vehicle{
	pixel_x = -7;
	pixel_y = 12
	},
/obj/structure/bed/chair/vehicle{
	pixel_x = 9;
	pixel_y = 12
	},
/turf/open/floor/engine,
/area/shuttle/arrowhead_new/elevator)
"D" = (
/turf/closed/shuttle/elevator,
/area/shuttle/arrowhead_new/elevator)
"G" = (
/obj/effect/decal/warning_stripes{
	icon_state = "S"
	},
/obj/effect/decal/warning_stripes{
	icon_state = "N";
	pixel_y = 1
	},
/obj/structure/machinery/power/apc/almayer/hardened,
/turf/open/shuttle/dropship{
	icon_state = "rasputin15"
	},
/area/shuttle/arrowhead_new/elevator)
"H" = (
/obj/effect/decal/warning_stripes{
	icon_state = "E";
	pixel_x = 1
	},
/obj/effect/decal/warning_stripes{
	icon_state = "W"
	},
/turf/open/floor/engine,
/area/shuttle/arrowhead_new/elevator)
"I" = (
/obj/effect/decal/warning_stripes{
	icon_state = "N";
	pixel_y = 1
	},
/obj/effect/decal/warning_stripes{
	icon_state = "S"
	},
/obj/structure/machinery/computer/shuttle/arrowhead/elevator_controller{
	pixel_x = 2;
	pixel_y = 41
	},
/turf/open/shuttle/dropship{
	icon_state = "rasputin15"
	},
/area/shuttle/arrowhead_new/elevator)
"J" = (
/turf/closed/shuttle/elevator{
	dir = 9
	},
/area/shuttle/arrowhead_new/elevator)
"L" = (
/obj/structure/machinery/door/poddoor/almayer{
	dir = 4;
	id = "east";
	indestructible = 1;
	name = "\improper Elevator Lock";
	unacidable = 1;
	unslashable = 1
	},
/turf/open/floor/almayer{
	icon_state = "test_floor4"
	},
/area/shuttle/arrowhead_new/elevator)
"M" = (
/obj/effect/decal/warning_stripes{
	icon_state = "W"
	},
/obj/effect/decal/warning_stripes{
	icon_state = "S"
	},
/obj/effect/decal/warning_stripes{
	icon_state = "NE-out";
	pixel_x = 1;
	pixel_y = 1
	},
/obj/structure/bed/chair/vehicle{
	dir = 1;
	pixel_x = -7
	},
/obj/structure/bed/chair/vehicle{
	dir = 1;
	pixel_x = 9
	},
/turf/open/floor/engine,
/area/shuttle/arrowhead_new/elevator)
"N" = (
/obj/effect/decal/warning_stripes{
	icon_state = "E";
	pixel_x = 1
	},
/obj/effect/decal/warning_stripes{
	icon_state = "S"
	},
/obj/effect/decal/warning_stripes{
	icon_state = "NW-out";
	pixel_y = 1
	},
/obj/structure/bed/chair/vehicle{
	dir = 1;
	pixel_x = 8
	},
/obj/structure/bed/chair/vehicle{
	dir = 1;
	pixel_x = -8
	},
/turf/open/floor/engine,
/area/shuttle/arrowhead_new/elevator)
"Q" = (
/obj/effect/decal/warning_stripes{
	icon_state = "N";
	pixel_y = 1
	},
/obj/effect/decal/warning_stripes{
	icon_state = "E";
	pixel_x = 1
	},
/obj/effect/decal/warning_stripes{
	icon_state = "SW-out"
	},
/obj/structure/bed/chair/vehicle{
	pixel_x = 8;
	pixel_y = 12
	},
/obj/structure/bed/chair/vehicle{
	pixel_x = -8;
	pixel_y = 12
	},
/turf/open/floor/engine,
/area/shuttle/arrowhead_new/elevator)
"T" = (
/turf/closed/shuttle/elevator{
	dir = 8
	},
/area/shuttle/arrowhead_new/elevator)

(1,1,1) = {"
J
D
D
D
a
"}
(2,1,1) = {"
m
C
A
M
T
"}
(3,1,1) = {"
b
I
q
G
k
"}
(4,1,1) = {"
T
Q
H
N
k
"}
(5,1,1) = {"
u
L
L
L
z
"}
